0 13 0 0 0 0 0 0 0 0 0 0 0 0 15 0  
0 0 0 0 0 0 0 0 0 0 0 0 0 0 0 0
6 0 0 0 0 0 1 0 0 0 0 0 0 0 0 0
0 0 0 13 0 0 0 0 0 0 0 0 0 14 0 0
0 0 0 0 0 0 0 0 0 0 0 0 0 0 0 0
1 0 6 0 0 6 0 0 0 0 0 9 10 0 0 0
6 0 0 0 1 0 0 0 0 0 0 11 12 0 0 15
13 0 0 0 0 0 13 0 0 0 0 0 0 0 0 0
0 0 6 6 0 0 0 0 0 0 0 14 0 0 14 0
1 0 0 0 0 0 0 0 0 0 0 0 14 9 10 0
0 0 6 0 0 1 0 0 0 0 0 0 0 11 12 0
6 0 0 0 0 0 1 0 0 0 0 0 14 0 0 15